11111111111111
1P011000C00111
10C011T0000111
1T001100110111
100110010T01E1
10C00001100001
11111111111111