1111111111111111111111111111111111111
1E000000000000000T1000CCC00000T0011C1
11110000000100C000T111C1111C00000T001
1E111000000000CCCC1111111110000011111
10000T11100000000000000000000C1111111
111000CCC00000000001110000000000P1111
1111111111111111111111111111111111111