111111111111111111111111
1CCC00CC00CC0CC00CCC0001
10C000CC00CCC000C000C001
1CCCC0CC00CC0CC01CCC1111
111111111P11111E11111111
111111111111111111111111