11111111111111111
10000100010001001
1000P000011110011
1E000110001100011
1CCCCC0000CCCCC01
1111CCC0CCC111111
11111100001111111
11111111111111111