111111111111111111111111111111111111111111111
10001CCC111111100P0C00000CC00000000000E00C001
1010010000C11111000000CC111111100000000001111
1CE10001100000000111CCCCC11111CCCCCC111111111
111111111111111111111111111111111111111111111