1111111111111111111111111111111111111111111111111
100000E0000000000E000000000000E000000000000E00001
10000CCC00000CCCCCC0000000CCCCCC00000000CCCCC0001
1000C00C0000000000C000000000000C000000000000C0001
100C000C0000000000C000000000000C000000000000C0001
1000000C00000CCCCCC0000000CCCCCC0000000000CCCCC01
1000000C0000000000C000000000000C000000000000C0001
1000000C0000000000C000000000000C000000000000C0001
10P00CCCCC000CCCCCC0000000CCCCCC000000000000C0001
1111111111111111111111111111111111111111111111111