11111111111111111111111111111111111111111111111111
11100000000000100000000001000000000010000000000011
1P100000000000100000000001000000000010000000000001
101CCCCCCCCC00100CCCCCC0010CC000CC00100CCCCCCCC001
101000000CC00010000CC000010CC00CC00010C00000000C01
1010000CC0000010000CC000010CC0CC00001C0000000000C1
100000CC00000000000CC000000CCCC000000C0000000000C1
10100CC000000010000CC000010CC0CC00001C0000000000C1
101CCCCCCCCC00100CCCCCC0010CC00CC00010C00000000C01
101000000000001000000000010000000000100CCCCCCCC001
11111111111111111110111111111111111111111111111111
1010CCCCCCC000100CCCCC00010CCCCCCC0010001100010001
1010C00000C00010C00000C0010C00000C0010001001E10001
1010CCCCCCC00000C00000C0000CCCCCCC0010001010000001
1010000000C00010C00000C0010000000C0000001010000001
1010CCCCCCC000100CCCCC00010CCCCCCC0010000010000001
11111111111111111111111111111111111111111111111111