11111111111111111111111111111111111111111111111111111111
10101000000000001000000000010000000000100000000000000001
10101000000000001000000000010000000000100000000000000001
10101CCCCCCCCC00100CCCCCC0010CC000CC00100CCCCCCCC0000001
10101000000CC00010000CC000010CC00CC00010C00000000C000001
101010000CC0000010000CC000010CC0CC00001C0000000000C00001
10100000CC00000000000CC000000CCCC000000C0000000000C000E1
1010100CC000000010000CC000010CC0CC00001C0000000000C00001
10101CCCCCCCCC00100CCCCCC0010CC00CC00010C00000000C000001
10101000000000001000000000010000000000100CCCCCCCC0000001
101010CCCCCCC000100CCCCC00010CCCCCCC00100000000000000001
101010C00000C00010C00000C0010C00000C00100000000000000001
101010CCCCCCC00010C00000C0010CCCCCCC00100000000000000001
101010000000C00010C00000C0010000000C00000000000000000001
10P010CCCCCCC000100CCCCC00010CCCCCCC00100000000000000001
11111111111111111111111111111111111111111111111111111111