111111111111111111111111111111111111111111111111
111E00C000C0000C0000C00P0C0000C0000C000C000C00E1
11100CCC0CCC00CCC00CCC00CCC00CCC00CCC0CCC0CCC011
111000C000C0000C0000C0000C0000C0000C000C000C0111
111000C000C0000C0000C0000C0000C0000C000C000C0001
11100CCC0CCC00CCC00CCC00CCC00CCC00CCC0CCC0CCC011
111000C000C0000C0000C0000C0000C0000C000C000C0111
111000C000C0000C0000C00E0C0000C0000C000C000C0001
11100CCC0CCC00CCC00CCC00CCC00CCC00CCC0CCC0CCC011
111E00C000C0000C0000C0000C0000C0000C000C000C0E11
111111111111111111111111111111111111111111111111